d+++++++d
dE.....Ed
dddd.dddd
#.......#
#.......#
#.......#
#.......#
#.......#
#.......#
#.......#
d##+++##d