d#####+#####d
#...........#
#...........#
#..#.....#..#
+...........+
#..#.....#..#
+...........+
#..#.....#..#
#...........#
#...........#
d#####+#####d