d###########
#..........+
#.d########d
#.#.E......d
#.#........d
#.#........d
#.#......E.d
#.+........d
#.#........d
#.#.....dddd
#.#.....+..d
#.#..E..d$$d
#+dddddddddd