d###d
#.$.#
#.E.#
#...#
#...#
#...#
#...#
d#+#d