d###+###d
#.......#
#.......#
#.......#
+.......+
#.......#
#.......#
#.......#
d###+###d